2 2 0 2 6 0 0 2 2 2
2 2 0 2 0 0 0 2 2 2
0 2 0 2 3 3 3 2 2 2
0 0 0 2 3 3 3 2 2 2
0 2 0 2 0 0 0 0 2 5
0 2 0 0 0 0 0 2 2 0
2 2 0 2 0 0 0 2 0 0
2 2 0 2 3 3 3 2 0 0
2 2 1 2 0 0 0 0 0 0
2 2 4 2 0 0 0 0 0 6